CH3-CH2(OH)	ethanol		ethanol
CH3-COOH	acetate		acetate
CH3-CHO		acetaldehyde	acetaldehyde
COOH-COOH	oxalate		oxalate
CHO-COOH	glyoxylate	glyoxylate
CH3-CH(OH)-COOH	lactate		lactate
CH3-CO-CH3	acetone		acetone
CH3-CO-COOH	pyruvate	pyruvate
CH2(OH)-CH(OH)-CH2(OH)	glycerol	glycerol
CH2(OH)-CH(OH)-COOH	glycerate	glycerate
CH2(OH)-CHp-COOH	2-phosphoglycerate	phosphoglycerate2
COOH-CH(OH)-CH2p	3-phosphoglycerate	phosphoglycerate3
CH2p-CH(OH)-COp	1,3-biphosphoglycerate		bpg
CHO-CH(OH)-CH2(OH)	glycerol_aldehyde	glyceraldehyde
CHO-CH(OH)-CH2p	glyceraldehyde_3-phosphate	glyceraldehydephos
CH2(OH)-CO-CH2(OH)	dihydroxyacetone	dihydroxyacetone
CH2(OH)-CO-CH2p	dihydroxyacetone_phosphate	dihydroxyacetonephos
CH2=C(OH)-COOH	enolpyruvate		enolpyruvate	
CH2=Cp-COOH	phosphoenolpyruvate	pep
CH3-COp	acetylphosphate			acetylphos
CH2(OH)-CH(OH)-CH2p	glycerol_3-phosphate	glycerol3phos
CH2(OH)-COOH	glycolate		glycolate
CH2(OH)-CH2-COOH	3-hydroxypropanoate	hydroxypropionateb
CH3-CH2-CH2(OH)	1-propanol		propanoln
CH3-CH(OH)-CH3	2-propanol		propanol2
CH2(OH)-CO-COOH	hydroxypyruvate		hydroxypyruvate
CH3-CH3	ethane		ethaneaq
COOH-CH=CH-COOH	fumarate	fumarate
COOH-CH2-CO-COOH	oxaloacetate	oxaloacetate
CH2=CH(OH)	vinylalcohol	vinylalcohol
CH2=CHp	vinylalcohol_phosphate	phospvinylalc
CH2=CO	ketene	ketene
CH2=CH2	ethene	ethene
CH3-CO-CH2-COOH	acetoacetate	acetoacetate
CHO-CH(OH)-CH(OH)-CH(OH)-CH2(OH)	arabinose	arabinose
CHO-CH(OH)-CH(OH)-CH(OH)-CH2p	arabinose-5-phosphate	arabinose5phos
CH3-CH2-CH2-CH2(OH)	butanol	butanoln
COOH-CH2-CH(OH)-COOH	malate	malate
CH3-CH2-CH2-CHO	butanal	butanal
CH3-CH2-CH2-COOH	butyrate	butyrate
CHO-CH2-CH(OH)-CH(OH)-CH2(OH)	deoxyribose deoxyribose
CHO-CH2-CH(OH)-CH(OH)-CH2p	deoxyribose-5-phosphate	deoxyribose5phos
CH2(OH)-CO-CH(OH)-CH(OH)-CH(OH)-CH2(OH)	fructose	fructose
CH2p-CO-CH(OH)-CH(OH)-CH(OH)-CH2p	fructose-1,6-phosphate	fructose16phos
CH2(OH)-CO-CH(OH)-CH(OH)-CH(OH)-CH2p	fructose-6-phosphate	fructose6phos
CHO-CH(OH)-CH(OH)-CH(OH)-CH(OH)-CH2(OH)	glucose glucose
CHO-CH(OH)-CH(OH)-CH(OH)-CH(OH)-CH2p glucose-6-phosphate	glucose6phos
COOH-CO-CH2-CH(OH)-COOH	4-hydroxy-2-oxo-glutarate	hydroxy2oxoglutarate
COOH-CH2-CH2-CH(OH)-COOH	4-hydroxyglutarate	hydroxyglutarate
CH2(OH)-CH(OH)-CH(OH)-CH(OH)-CH(OH)-CH2(OH)	iditol	iditol
COOH-CH2-CH2-CO-COOH	ketoglutarate	ketoglutarate
CHO-CH(OH)-CH(OH)-CH(OH)-CH2(OH)	ribose	ribose
CHO-CH(OH)-CH(OH)-CH(OH)-CH2p	ribose-5-phosphate	ribose5phos
CH2(OH)-CO-CH(OH)-CH(OH)-CH2(OH) ribulose	ribulose
CH2(OH)-CO-CH(OH)-CH(OH)-CH2p	ribulose-5-phosphate	ribulose5phos
COOH-CH2-CH2-COOH	succinate	succinate
CH3-CH(NH2)-COOH	alanine	alanine
CO(NH2)-CH2-CH(NH2)-COOH	asparagine	asparagineL
COOH-CH2-CH(NH2)-COOH	aspartate	aspartate
COOH-CH2-CH2-CH(NH2)-COOH	glutamate	glutamate
CO(NH2)-CH2-CH2-CH(NH2)-COOH	glutamine	glutamine
CH2(NH2)-COOH	glycine	glycine
CH2(OH)-CH(NH2)-COOH	serine	serineL
CH3-CH(OH)-CH(NH2)-COOH	threonine	threonine